# #########
# #       #
# # ### # #
# #   # # #
# # ### # #
# # #   # #
# ### ### #
#   # # # #
### # # # #
#     #   #
######### #
